B,B,B,B,D,D,B,B,B,B,
B,-,-,-,-,-,-,-,-,B,
B,-,-,-,-,-,-,-,-,B,
B,-,-,-,-,-,-,-,-,B,
B,-,-,-,-,-,-,-,-,B,
B,-,-,-,-,-,-,-,-,B,
D,-,-,-,-,-,-,-,-,D,
D,-,-,-,-,-,-,-,-,D,
B,-,-,-,-,-,r,r,r,B,
B,-,-,-,-,-,r,r,r,B,
B,s,-,-,s,-,r,r,r,B,
B,-,-,-,-,-,r,r,r,B,
B,-,-,-,-,-,r,r,r,B,
B,B,B,B,D,D,B,B,B,B,
