B,B,B,B,D,D,B,B,B,B,
B,r,r,r,r,r,r,r,r,B,
B,r,r,r,r,r,r,r,r,B,
B,-,-,-,-,-,-,r,r,B,
B,-,-,-,-,-,-,r,r,B,
B,-,-,-,-,-,-,r,r,B,
D,-,-,-,-,-,-,r,r,D,
D,-,-,-,-,-,-,r,r,D,
B,-,-,-,-,-,-,r,r,B,
B,-,-,-,-,-,-,r,r,B,
B,-,-,-,-,-,-,r,r,B,
B,r,r,-,-,-,-,r,r,B,
B,r,r,-,-,-,-,r,r,B,
B,B,B,B,D,D,B,B,B,B,
