B,B,B,B,D,D,B,B,B,B,
B,-,-,-,-,-,-,-,-,B,
B,-,-,-,-,-,-,-,-,B,
B,-,s,-,-,-,s,-,-,B,
B,-,-,-,-,-,-,-,-,B,
B,-,-,-,-,-,-,-,-,B,
D,-,r,r,r,r,r,-,-,D,
D,-,r,r,r,r,r,-,-,D,
B,-,-,-,-,-,-,-,-,B,
B,-,-,-,-,-,-,-,-,B,
B,-,-,-,-,-,-,-,-,B,
B,-,-,-,-,-,-,-,-,B,
B,-,-,-,-,-,-,-,-,B,
B,B,B,B,D,D,B,B,B,B,
