B,B,B,B,D,D,B,B,B,B,
B,-,-,-,-,-,-,-,-,B,
B,-,r,-,-,-,r,r,-,B,
B,-,-,-,-,-,r,-,-,B,
B,-,-,-,-,-,r,-,-,B,
B,-,-,-,-,-,r,-,-,B,
D,-,s,-,-,-,-,-,-,D,
D,-,-,-,-,-,-,-,-,D,
B,-,-,-,r,-,-,-,-,B,
B,-,r,r,r,-,-,s,-,B,
B,-,r,-,-,-,-,-,-,B,
B,-,-,-,-,-,-,-,-,B,
B,-,-,-,-,-,-,-,-,B,
B,B,B,B,D,D,B,B,B,B,
