B,B,B,B,D,D,B,B,B,B,
B,-,r,-,-,-,-,-,-,B,
B,-,s,-,-,-,-,-,-,B,
B,-,-,-,-,-,-,-,-,B,
B,-,-,-,-,-,-,-,-,B,
B,-,-,-,-,-,-,-,-,B,
D,-,-,-,-,-,s,-,-,D,
D,-,-,-,-,-,-,-,-,D,
B,-,-,-,-,-,-,-,-,B,
B,-,-,-,-,-,-,-,-,B,
B,-,-,-,-,-,s,-,-,B,
B,-,-,-,-,-,-,-,-,B,
B,-,-,-,-,-,-,-,-,B,
B,B,B,B,D,D,B,B,B,B,
