B,B,B,B,D,D,B,B,B,B,
B,-,-,-,-,r,-,-,-,B,
B,-,-,-,-,-,-,r,-,B,
B,r,-,s,-,-,-,r,r,B,
B,r,r,-,-,-,-,-,-,B,
B,-,r,-,-,-,-,-,-,B,
D,-,-,-,r,-,s,-,-,D,
D,-,-,-,r,-,-,-,-,D,
B,-,-,-,r,-,-,-,-,B,
B,-,-,-,r,r,r,-,-,B,
B,r,-,-,-,-,-,-,-,B,
B,r,r,-,-,-,-,r,r,B,
B,r,r,r,-,-,-,-,r,B,
B,B,B,B,D,D,B,B,B,B,
