B,B,B,B,D,D,B,B,B,B,
B,-,-,r,-,-,-,-,-,B,
B,-,-,r,-,-,-,-,-,B,
B,-,-,r,-,-,-,-,-,B,
B,s,-,r,-,-,-,-,-,B,
B,-,-,r,-,-,-,-,-,B,
D,-,-,r,-,-,-,-,-,D,
D,-,-,-,-,-,-,-,-,D,
B,-,-,-,-,-,-,-,-,B,
B,-,-,r,r,r,r,-,-,B,
B,-,-,r,-,-,-,-,-,B,
B,s,-,r,-,-,-,s,-,B,
B,-,-,r,-,-,-,-,-,B,
B,B,B,B,D,D,B,B,B,B,
