B,B,B,B,D,D,B,B,B,B,
B,r,r,r,-,-,r,-,s,B,
B,r,r,r,-,-,r,-,-,B,
B,r,r,r,-,-,r,-,-,B,
B,r,r,r,-,-,-,-,-,B,
B,-,-,-,-,-,r,r,r,B,
D,-,-,-,-,-,r,-,-,D,
D,-,-,r,s,-,r,-,-,D,
B,-,-,r,-,-,r,-,-,B,
B,-,-,r,-,-,r,-,-,B,
B,-,-,r,r,r,r,-,-,B,
B,-,s,-,-,-,-,-,-,B,
B,-,-,-,-,-,-,-,-,B,
B,B,B,B,D,D,B,B,B,B,
