B,B,B,B,D,D,B,B,B,B,
B,-,-,-,-,-,-,-,-,B,
B,-,-,-,-,-,-,-,-,B,
B,-,-,-,-,r,r,r,-,B,
B,-,s,-,-,-,-,s,-,B,
B,-,-,-,-,-,-,-,-,B,
D,-,-,-,-,-,-,-,-,D,
D,-,r,r,r,r,-,-,-,D,
B,-,-,-,-,-,-,-,-,B,
B,-,s,-,-,-,-,-,-,B,
B,-,-,-,-,-,s,-,-,B,
B,-,-,-,-,-,-,-,-,B,
B,-,-,-,-,-,-,-,-,B,
B,B,B,B,D,D,B,B,B,B,
