B,B,B,B,D,D,B,B,B,B,
B,r,r,r,r,r,r,r,r,B,
B,r,r,r,r,r,r,r,r,B,
B,r,r,r,r,r,r,r,r,B,
B,-,-,-,-,-,-,-,-,B,
B,-,-,-,-,-,-,-,-,B,
D,-,-,-,-,-,-,-,-,D,
D,-,-,-,s,-,-,-,-,D,
B,-,-,-,-,-,-,-,-,B,
B,-,-,-,-,-,-,-,-,B,
B,r,r,r,r,r,r,r,r,B,
B,r,r,r,r,r,r,r,r,B,
B,r,r,r,r,r,r,r,r,B,
B,B,B,B,D,D,B,B,B,B,
