B,B,B,B,D,D,B,B,B,B,
B,-,-,-,-,-,-,-,-,B,
B,-,-,-,-,-,s,-,-,B,
B,-,-,s,-,-,-,-,-,B,
B,-,-,-,-,r,r,r,-,B,
B,-,r,r,r,r,-,-,-,B,
D,-,-,-,-,-,-,-,-,D,
D,s,-,-,-,-,-,-,-,D,
B,-,-,-,-,-,-,-,-,B,
B,-,-,r,r,-,-,-,-,B,
B,-,r,r,r,r,r,r,-,B,
B,-,-,s,-,-,-,-,-,B,
B,-,-,-,-,-,-,s,-,B,
B,B,B,B,D,D,B,B,B,B,
